R 480 360
NO ./textures/greystone.xpm
SO ./textures/eagle.xpm
EA ./textures/colorstone.xpm
WE ./textures/purplestone.xpm
S ./textures/barrel.xpm
C 255,0,0
F 0,0,255

11111111111111111
10000000000000001
10000000000000001
10000000000000001
10000000000000001
10000000000000001
10000000N00000001
10000000000000001
10000000000000001
10000000000000001
10000000000000001
10000000000000001
11111111111111111
