R 600 360

NO ./textures/Wall_no.xpm
SO ./textures/Wall_1.xpm
EA ./textures/Wall_1.xpm
WE ./textures/Wall_1.xpm

S  ./textures/barrel.xpm

F  ./textures/floor_paved.xpm
C  ./textures/skybox_sky.xpm

              1111111111111111111
              1222222210000000001
              1200000210400000001
              1222200210000000001
111111111111111111100111000400001
100000000100000010000111000000001
1E0000000500000050000631000000001
100000000100000010000111000000001
111111111111111111100111000000001
             11100000000000000041
             13600000000400000001
             11100000000000004001
             11111111111111111111
