R 600 360

NO ./textures/Wall_no.xpm
SO ./textures/Wall_1.xpm
EA ./textures/Wall_1.xpm
WE ./textures/Wall_1.xpm

S  ./textures/barrel.xpm

F  ./textures/floor_paved.xpm
C  ./textures/skybox_sky.xpm

                                            1 1 1
                                        111101111111
                                    11111000000000011
                                 1110000000000000010011
                                100000000000000000020001      1
                               10000000000000000000000001111111
                              1000000000100000011110000001000031
                              1000000000011100001111111000000001
                             100000000001   1111  1111111010111   11
                             1000000000011             111111   11001
                             1000000000000111111111           110011 1 1
                              10000000000000000000011111111111100101 11111
                               1000000000000000000001111100000311 1 13101
                                1100000000000000000000011611111    10001
                                 110000000000000000000000011111111001
                                   1110000000000000000000000005005001
                                      1121200000N0000000000000111111
                             1         111200000000000000021111
                            101          112000000000000000021111
                 1           1011 1111111200000000000000000021111
                101         110001000222000000000000000000221111
                 1111  1111100000000000000000000000000022211111
                  10011000000000000000000000000000222211111
           1     11000000000000000000000000222211111111
          101  110000000000000000000001111111111     111
          1001100000000000000000011111111     1111111001111111
           1005000000000000011111111     1111100000000400000001111
            10100000000000111111      1111000000000000000000000001111
   1         100000000000111111      1000000000111111111110000000000011
  11         10000040000011111      1000000001111       1111100000000001
  1 1        100000000000011111    10000001111             11110000000001
 1   1       1000000000000011111  1000001111                11110004000001
 1  1 1      100100000000000111111000001111                111100000000001
 1  1  1      111000040000000111131100111                1111000000000011
 1 111 11   1    11000000000000016111111111          111111000000000001
1   1311  1        100000000000000000011111111111111111111000000000001
1   1001 1 1        1111000000000000000000000000000000000000000001001
 1  10001 1 1  1        11000000000000000000400000000000040000011 1101
  1  1000111111011111111110000001110000000000000000000000001111     1
    11100000000000000000000000111  10011111111100111111111001
       11110000000000040000011     101         101        101
        11111111111111111111        1           1          1
