R 640 360

NO ./textures/mossy.xpm
SO ./textures/greystone.xpm
EA ./textures/redbrick.xpm
WE ./textures/purplestone.xpm

S ./textures/barrel_wolfd3d.xpm

C  00, 128, 255
F  255,128, 0

1111111111111111111111111
1000000000110000000000001
1011000001110000002000001
1001000000000000000000001
1111111110110000011100001
10000000001100000111011111111
11110111111111011100000012221
11110111111111011101010010001
11000000110101011100000000001
10002000000000000000000000001
10000000000000001101210000001
11000001110101011111011100S01
11110111 1110101 101111010001
11111111 1111111 111111111111
