R 640 360
NO ./textures/Wall_no.xpm
SO ./textures/Wall_1.xpm
EA ./textures/Wall_1.xpm
WE ./textures/Wall_1.xpm
S  ./textures/barrel.xpm
F  00, 128, 255
C  255,128,00

1111111111111111111
1000001000001000021
1E00000000001000001
1000001000000000001
1110111000001002001
1012101000001000001
1111111101111111111
     1000001
     1000001
     1000001
     1000001
     1000001
     1000001
     1000001
     1000001
     1000001
     1000001
     1000001
     1000001
     1000001
     1000001
     1000001
     1000001
     1000001
     1000001
     1000001
     1000001
     1111111
