R 640 360
NO ./textures/Wall_no.xpm
SO ./textures/Wall_1.xpm
EA ./textures/Wall_1.xpm
WE ./textures/Wall_1.xpm
S  ./textures/barrel.xpm
F  ./textures/floor_paved.xpm
C  ./textures/Skybox_Mountains.xpm

1111111111111111111
1000001000001202021
1E00005000001002001
1000001000000002001
1116111000001000001
1213101000001200021
1111111101111111111
     1000001
     1000001
     1000001
     1000401
     1000001
     1000001
     1000001
     1400001
     1000001
     1000001
     1000001
     1000001
     1000041
     1000001
     1400001
     1000001
     1000001
     1000001
     1004001
     1000001
     1111111
